16 16
################
#..............#
#..............#
#..............#
#..............#
#....$.........#
#..............#
#..........a...#
#...........-..#
#..............#
#..........a$..#
#..............#
#...........$..#
#..............#
#..............#
###########b####
